11111111111111111111111111111111111111111111111111
10000000000000000000000000000000000000000000000001
10000000000000000000000011111000000000000000000001
10000000000000000000000011111000000000000000000001
10000000000000000000000011111000001111100000000001
10000000011111000000000000000000000000011111000001
10000000011111000000000000E00000000000011111000001
10000000011111000000000000000000000000011111000001
10000000000000000000000011111000000000000000000001
10000000000000000000000011111000000000000000000001
10000000000000000000000000000000000000000000000001
11111111111111111111111111111111111111111111111111