

R 1200 700



NO ./path_to_the_north_texture

SO ./path_to_the_south_texture

WE ./path_to_the_west_texture

EA ./path_to_the_east_texture

S ./path_to_the_sprite_texture

F 220,100,0

C 225,30,0

111111111111111111111111111111111111
100000000000000000000000000000000001
100000000000000011111111000000001
100000000000000000000000000000000001
10000000000000000000011111111000001
100000000000000000000011000000000001
100001111111111100000010000000000001
100001111111111100000010000000000001
100000111111111100000010000000000001
100000011111111100000010000000000001
100001111111111100000010000000000000100001111111111100000010000000000001
                                   000001111110000000000001100000000001
100001111110000000000001100000000000    1111110000000000001100000000001
100000000000000011111111111111000001    1111110000000000001100000000001
100000000000000000001111111111100000000001111110000000000001100000000001
100000000000000000000011000000000001    00000000000000000001100000000001
100001111110000000000001100000000001
1000000000000000E0000011000000000001
100000000000000000000011000000000001
100000000000000000000011000000000001
100000000000000000000011000000000001
100000000000000000000000000000000001
100000000000000000000011000000000001
100000000000000000000000100000000001
111111111111111111111111111111111111
111111111111111111111111111111111111



