11111111111111111111111111111111111111111111111111111111111111
10000000000000000000100011111000000200000000000001111111111111
10000000000000000000100011111000000000000000000000000000000111
10000000000000000000100000000000000000000000000001111000100111
11111111111111111101111110000000000000001111111111111111111111
10000000000000000000100000000000000000000000000111111111111111
10000000000000000000111111111000002000000001000001000000100111
10000000000000000000111111111000002000000001000001000000100011
10000000000000000000111111111000000000000001000001000000000101
10000000011111000000100000000000000000011111000000011111101101
10000000011111000000100000000000000000011111000001111111100001
1000000001111111111110000000000000000011111000000000011101111
10000000011111111111100000000000000000011111000000000010001111
10000000011111111111100000000000000000011111000001100100000111
10000000011111111000000000000000000111110000011111010100001111
10000000000000000000100011111000000000000000000001111111111111
10000000000000000000100011111000000000000000000000000000000111
1000000000000000000010000N000000000000000000000001111000100111
11111111111111011101111110000000000000001111111111111111111111
11111111111111111111111111111111111111111111111111000000000000