

R 800 600



NO ./textures/basic/north.xpm

SO ./textures/basic/south.xpm

WE ./textures/basic/west.xpm

EA ./textures/basic/east.xpm

S ./sprites/0.xpm

F 0,0,0

C 82,200,250

1111111111
1111111111
1000  0011
11000S0001
111111111

