




1111111111
1000001001
1000S01001
1001000001
1111111111









