

R 900 700



NO ./textures/basic/north.xpm

SO ./textures/basic/south.xpm

WE ./textures/basic/west.xpm

EA ./textures/basic/east.xpm

S ./sprites/0.xpm

F 69,69,69

C 94,201,247


111111111111111111111111111111111111111111111111111111111111111111111
100000000000000000000000000000000000000000000000000000000000000000001
100000000000000000000000000000000000000000000000000000000000000000001
100000000000000000000000000000000000000000000000000000000000000000001
100000000000000000000000000000000000000000000000000000000000000000001
100000000000000000000000000000000000000000000000000000000000000000001
100000000000000000000000000000000000000000000000000000000000000000001
100000000000000000000000000000000000000000000000000000000000000000001
100000000000000000000000000000000000000000000000000000000000000000001
100000000000000000111111111111111111111111111111110000000000000000001
100000000000000000100000000000000000000000000000010000000000000000001
100000000000000000100000000000000000000000000000010000000000000000001
100000000000000000100000000000000000000000000000010000000000000000001
100000000000000000100000000000000000000000000000010000000000000000001
100000000000000000100000000011111111111100000000010000000000000000001
100000000000000000100000000000000000000000000000010000000000000000001
100000000000000000100000000000000000000000000000010000000000000000001
100000000000000000100000000000000000000000000000010000000000000000001
100000000000000000100000000000000000000000000000010000000000000000001
100000000000000000100000000000000000000000000000010000000000000000001
100000000000000000100000000000000000000000000000010000000000000000001
100000000000000000100000000000000000000000000000010000000000000000001
100000000000000000100000000000000000000000000000010000000000000000001
100000000000000000111111111000000N00000001111111110000000000000000001
100000000000000000100000000000000000000000000000010000000000000000001
100000000000000000100000000000000000000000000000010000000000000000001
100000000000000000100000000000000000000000000000010000000000000000001
100000000000000000100000000000000000000000000000010000000000000000001
100000000000000000100000000000000000000000000000010000000000000000001
100000000000000000100000000000000000000000000000010000000000000000001
100000000000000000100000000000000000000000000000010000000000000000001
100000000000000000100000111111111111111111100000010000000000000000001
100000000000000000100000110000000100000001100000010000000000000000001
100000000000000000100000110000000100000001100000010000000000000000001
100000000000000000100000000000000100000000000000010000000000000000001
100000000000000000100000000000000000000000000000010000000000000000001
100000000000000000111111000000000000000000011111110000000000000000001
100000000000000000000000000000000000100000000000000000000000000000001
100000000000000000000000000000000000100000000000000000000000000000001
100000000000000000000000000000000000100000000000000000000000000000001
100000000000000000000000000000000000100000000000000000000000000000001
100000000000000000000000000000000000100000000000000000000000000000001
100000000000000000000000000000000000111111111111100000000000000000001
100000000000000000000000000000000000000000000000000000000000000000001
100000000000000000000000000000000000000000000000000000000000000000001
100000000000000000000000000000000000000000000000000000000000000000001
100000000000000000000000000000000000000000000000000000000000000000001
111111111111111111111111111111111111111111111111111111111111111111111
